# Prefix_A = [CZ]\n\n\n , Prefix_B = [EN]\n\n\n
// á č ď é ě í ň ó ř š ť ú ů ý ž

nula = zero

jedna = one
dvě = two
tři = three
čtyři = four
pět = five
šest = six
sedm = seven
osm = eight
devět = nine
deset = ten

jedenáct = eleven
dvanáct = twelve
třináct = thirteen
čtrnáct = fourteen
patnáct = fifteen
šestnáct = sixteen
sedmnáct = seventeen
osmnáct = eighteen
devatenáct = nineteen
dvacet = twenty

třicet = thirty
čtyřicet = forty
padesát = fifty
šedesát = sixty
sedmdesát = seventy
osmdesát = eighty
devadesát = ninety
sto = one hundred

dvě stě = two hundred
tři sta = three hundred
čtyři sta = four hundred
pět set = five hundred
šest set = six hundred
sedm set = seven hundred
osm set = eight hundred
devět set = nine hundred

jeden tisíc = one thousand
dva tisíce = two thousand
tři tisíce = three thousand
čtyři tisíce = four thousand
pět tisíc = five thousand
šest tisíc = six thousand
sedm tisíc = seven thousand
osm tisíc = eight thousand
devět tisíc = nine thousand



